{
	"room": "W0N0",
	"terrain": [
		"##################################################",
		"#................................................#",
		"#................................................#",
		"#................................................#",
		"#................................................#",
		"#................................................#",
		"#................................................#",
		"#................................................#",
		"#................................................#",
		"#................................................#",
		"#................................................#",
		"#................................................#",
		"#................................................#",
		"#................................................#",
		"#................................................#",
		"#................................................#",
		"#................................................#",
		"#................................................#",
		"#................................................#",
		"#................................................#",
		"#................................................#",
		"#................................................#",
		"#................................................#",
		"#................................................#",
		"#................................................#",
		"#................................................#",
		"#................................................#",
		"#................................................#",
		"#................................................#",
		"#................................................#",
		"#................................................#",
		"#................................................#",
		"#................................................#",
		"#................................................#",
		"#................................................#",
		"#................................................#",
		"#................................................#",
		"#................................................#",
		"#................................................#",
		"#................................................#",
		"#................................................#",
		"#................................................#",
		"#................................................#",
		"#................................................#",
		"#................................................#",
		"#................................................#",
		"#................................................#",
		"#................................................#",
		"#................................................#",
		"##################################################"
	],
	"structures": [],
	"flags": [
		{
			"name": "goal",
			"x": 40,
			"y": 25
		}
	]
}
