{
	"room": "W0N1",
	"terrain": [
		"##################################################",
		"#####............................................#",
		"####.............................................#",
		"##...............................................#",
		"##...............................................#",
		"#................................................#",
		"#................................................#",
		"#................................................#",
		"#................................................#",
		"#................................................#",
		"#................................................#",
		"#................................................#",
		"#................................................#",
		"#................................................#",
		"#................................................#",
		"#................................................#",
		"#................................................#",
		"#................................................#",
		"#................................................#",
		"#................................................#",
		"#................................................#",
		"#................................................#",
		"#................................................#",
		".........................###.....................#",
		"........................###......................#",
		".......................###.......................#",
		".......................###.......................#",
		"#......................###.......................#",
		"#.......................###......................#",
		"#................................................#",
		"#................................................#",
		"#................................................#",
		"#................................................#",
		"#................................................#",
		"#................................................#",
		"#................................................#",
		"#................................................#",
		"#................................................#",
		"#................................................#",
		"#................................................#",
		"#................................................#",
		"#................................................#",
		"#................................................#",
		"#................................................#",
		"#................................................#",
		"#................................................#",
		"#...............................................##",
		"#..............................................###",
		"#...........................................######",
		"##################################################"
	],
	"structures": [
		{
			"type": "controller",
			"x": 26,
			"y": 28
		},
		{
			"type": "source",
			"x": 48,
			"y": 47
		},
		{
			"type": "source",
			"x": 3,
			"y": 2
		},
		{
			"type": "mineral",
			"x": 23,
			"y": 25,
			"mineralType": "O"
		}
	],
	"flags": []
}