{
	"room": "W1N1",
	"terrain": [
		"##################################################",
		"#................................................#",
		"#................................................#",
		"#................................................#",
		"#................................................#",
		"#................................................#",
		"#................................................#",
		"#................................................#",
		"#........###.....................................#",
		"#.......####.....................................#",
		"#.......###......................................#",
		"#.......##.......................................#",
		"#................................................#",
		"#................................................#",
		"#................................................#",
		"#................................................#",
		"#................................................#",
		"#................................................#",
		"#................................................#",
		"#................................................#",
		"#................................................#",
		"#................................................#",
		"#................................................#",
		"#.................................................",
		"#.................................................",
		"#.................................................",
		"#.................................................",
		"#................................................#",
		"#................................................#",
		"#................................................#",
		"#................................................#",
		"#................................................#",
		"#................................................#",
		"#................................................#",
		"#................................................#",
		"#................................................#",
		"#................................................#",
		"#................................................#",
		"#................................................#",
		"#.......................................###......#",
		"#......................................####......#",
		"#.....................................#####......#",
		"#......................................##........#",
		"#................................................#",
		"#................................................#",
		"#................................................#",
		"#................................................#",
		"#................................................#",
		"#................................................#",
		"##################################################"
	],
	"structures": [
		{
			"type": "controller",
			"x": 25,
			"y": 15,
			"owner": "me",
			"level": 1
		},
		{
			"type": "source",
			"x": 10,
			"y": 10
		},
		{
			"type": "source",
			"x": 40,
			"y": 40
		}
	],
	"flags": []
}